                                           S         C   O       U         Z     R                                             
                                           M         O   U       K         W     O                                             
  #########################################.#########.###.#######.#########.#####.###########################################  
  #.#...#...#.....#.#.#...#.............#...#.#.....#...#...#...........#.#.....#...........#...#.#...#.#.#...#.#...#...#.#.#  
  #.###.###.#.#.###.#.###.###########.#.###.#.#.#######.###.###########.#.###.#.#######.#.#.###.#.#.###.#.#.###.#.###.###.#.#  
  #...#.#.#...#.#.........#...#.#...#.#.......#.....#...#.#.#.#...#.........#.#.#.......#.#.......................#.........#  
  #.###.#.#####.###.#####.###.#.###.#####.#####.#####.###.#.#.###.#.#.#.#.#####.#.###.#####.#.###.#.###.#.#####.#####.#####.#  
  #.#.#.#...............#.......................#.#...#.#.....#...#.#.#.#.#.....#...#.#...#.#...#.#...#.#.#.#.#.#.......#.#.#  
  #.#.#.#########.#.#.#####.#.#.#######.#######.#.#.#.#.###.#####.#.#.#####.###.#.#####.#####.#.###.#.###.#.#.###.#####.#.###  
  #.#.#.#.....#.#.#.#.#.#...#.#.#...#.....#...#...#.#.....#.....#...#...#.#.#.#.#.........#.#.#.#...#.#...#...#.#.#...#.#.#.#  
  #.#.#.###.###.#######.#####.###.###.#######.#.#######.###.#.###.#.#.###.###.#.###.#.#.###.#.###.#.#.#####.###.#.#.#####.#.#  
  #.#...#.......#.........#.....#.#.#...#.#.#.....#.......#.#...#.#.#...#.........#.#.#...#.#...#.#.#.#...#...........#...#.#  
  #.#.#####.#############.#######.#.#####.#.###.###.###########.#.#.#.#.#.#####.###.###.###.#####.#.#####.#.###.###.###.###.#  
  #.......#...#.......#...........................#.....#.#...#.#.#.#.#.#...#.....#.#...........#.#...#.#...#.#.#.#...#.....#  
  #####.###.###.###.###.###.#.###.#####.#.#.###########.#.#.#.#.#.#######.#.#####.#.###.#####.#########.###.#.###.#####.#####  
  #...#.....#.#.#.#.#.#.#.#.#.#.#.#.#...#.#.#...#.........#.#.#.#.#.#.....#.#.#.#.#.#.......#.................#.#.#.....#...#  
  ###.###.###.###.#.#.###.#####.###.#####.###.#.###.#########.#.#.#.#####.###.#.#######.#######.###.#.###.#.#.#.#.###.#####.#  
  #.#.#.......#.................#.#.#.........#.#.......#.......#...#...............#...#.....#.#.#.#.#.#.#.#...#.....#.#...#  
  #.#.###.###.#.#.#.###.###.###.#.#.#####.#.###.###.#.#########.#.#######.#.#.#.#######.#.#######.###.#.#######.#####.#.###.#  
  #...#.#.#.#.#.#.#...#...#.#.#...........#.#.#.#...#.#.....#.#.#...#.#...#.#.#.#.#.................#.......#.#...#.....#...#  
  ###.#.#.#.#.#####.#.#######.#.#.###.###.###.#.###.#####.#.###.#.###.#####.###.#.#####.###.#######.#.#######.#########.#.###  
  #.........#...#.#.#.#.......#.#.#...#...#.#.....#.....#.#...#.#.#.....#...#.#.#.....#...#.......#.#...#.......#.#...#.....#  
  ###.###.#######.#####.#####.#.#.#######.#.###.#.#.###.#.#.###.#.###.###.###.###.###.#.#.###############.###.###.###.###.###  
  #.#...#.#.......#.#.#.#...#...#...#.....#.#...#.#.#.#.#.#.#...#.......#.......#.#.#...#...#.#.........#.#.#.....#.........#  
  #.#####.#####.###.#.#####.#.###########.#.###.###.#.#.#.#.#.#.#.#####.#######.###.#.#####.#.###.#######.#.#############.###  
  #.#.#.#...#.....#...#.......#...#.#.#.#.#.......#...#.#.#...#.#.#.......#.......#.#...#.#.#.#.#.#...#.....#.#.#.#.#.#.....#  
  #.#.#.#.###.#.###.###.###.#.###.#.#.#.###.#.#####.#.###.#.#.###.###.#########.###.#.###.###.#.#.###.#.#####.#.#.#.#.###.###  
  #...#...#.#.#.#.....#.#.#.#.#.......#.....#...#...#...#.#.#.#...#.......#.#.#.#...#.............#.#.#...#...#.#...........#  
  #.#.#.###.###.###.#####.#########.###.###.###.#.#.#####.#############.###.#.#.#.#.#.###.#.#.#.###.#.#.#####.#.#.#.#.#.###.#  
  #.#...#...#.#...#...#...#...#.#.....#.#.#.#...#.#.#.#.#.......#.#.#...#.......#.#...#.#.#.#.#.#.#.............#.#.#.#.#...#  
  #####.#.###.#.###.#####.###.#.#.#.###.#.###.###.###.#.#####.###.#.#.#####.#.###.#####.#.###.###.#.###########.#########.###  
  #.#.#.#.#.#.....#.#.#.#.#...#...#.#.#.#.......#.......#.#...#.....#...#...#...#.....#.#.#.#.#.#.....#...#.#.#.#.#.#.#.#...#  
  #.#.#.#.#.#.#####.#.#.#.###.#####.#.#####.#.#.#####.###.###.###.#.#.#######.###.###.#.###.#.#.###.###.###.#.###.#.#.#.#.#.#  
  #.......#.#.....#...........#.#.#.......#.#.#.#.....#...#.#...#.#...#.....#...#...#.......#...#.................#.......#.#  
  #######.#.#.#####.###.#####.#.#.###.###.#####.#.#####.###.###.#.#########.#.#########.###.#######.###.#.#.###############.#  
  #.....#.....#...#.#.#...#.....#...#.#.........#.....#.........#.........#.......#.......#.#.#.......#.#.#...#...#...#.....#  
  ###.###.#######.###.#######.#.#.#######.#########.#######.###########.###.#########.#######.#####.###########.#.#.###.#.#.#  
  #.#.#.......#.#.#.#.#...#.#.#.#...#    H         G       U           O   O         Z    #.#...#.......#.....#.#...#.#.#.#.#  
  #.#.###.#.###.#.#.#.###.#.###.###.#    Y         M       K           H   U         W    #.###.#.#########.#######.#.#####.#  
  #.......#.#.#.....#.#.......#.....#                                                     #.#.......#.#.#.#.#...............#  
  #.#.#######.#####.#.#####.#.#.###.#                                                     #.###.#.###.#.#.#.#####.#########.#  
TV..#...#...#.#.#.......#...#.....#..AO                                                   #.#...#...#.#.#...#.#.#...#.....#.#  
  ###.#####.#.#.#####.#####.#######.#                                                     #.###.#.###.#.#.###.#.###.#######.#  
ZZ....#.#...#.#...#.......#.....#...#                                                     #...#.#.........#.#.#.#.#...#.....#  
  #.###.#.#.#.#.###.###.#.###.#####.#                                                     #.#.#.#####.###.#.#.#.###.#.#.#####  
  #.......#...........#.#.......#.#.#                                                   FA..#.....#.#.#.#...........#.#......DI
  #####################.#.#.#.###.###                                                     ###.#####.###.#############.#######  
  #.....#.............#.#.#.#.#.#...#                                                     #...#...............#...#.#.#......AO
  #.#.###.#.###.#.###.#####.###.#.#.#                                                     #####.#####.#.###.#.#.#.#.###.#####  
LU..#.....#.#...#.#.#...#.#.#.....#.#                                                   DR......#.....#.#.#.#...#.#...#.....#  
  #####.#.#####.###.#.###.#####.###.#                                                     #.#.#####.#####.#######.#.#.#####.#  
  #.#.#.#.....#.#...........#.....#..ZA                                                   #.#.#.......#...........#.#.......#  
  #.#.###.#####.#####.#####.#.#.#.#.#                                                     #######.#######.#.#.#####.###.#.#.#  
  #...#.#...#.#.....#.#.......#.#.#.#                                                     #.#...#...#.....#.#.......#...#.#.#  
  ###.#.#####.#.#####.#########.#####                                                     #.#.#####.#########.###.#.#####.###  
  #.........#...#...#.#.....#.#.....#                                                   CQ..#.....#.#...#.......#.#.#.#...#..FA
  #.#######.#####.#######.#.#.#######                                                     #.###.#####.#############.#.#####.#  
WA......#...#.#.#...#.#...#...#.....#                                                     #.#...#...#.....#.#.#.#.#...#...#.#  
  #.#####.###.#.###.#.###.###.#.###.#                                                     #.###.#.#####.#.#.#.#.#.#####.###.#  
  #.#.#...#.#.#.#.#.....#...#.#...#..OB                                                   #.#.......#...#.#.#.......#.#.#.#.#  
  ###.###.#.#.#.#.#.###.###.#.###.###                                                     #.#.#.#########.#.#.#####.#.#.#.#.#  
  #.....#.............#.....#.......#                                                     #...#.................#...........#  
  #.#########.#.#.###.#.###.#.#.#.###                                                     #########################.#####.#.#  
  #.....#.....#.#.#.#.#.#...#.#.#.#.#                                                     #...#...................#.#...#.#.#  
  #.###.#####.#.#.#.#############.#.#                                                     #.#.#.#######.#.#####.#####.#.###.#  
  #...#...#...#.#.#.....#.#.#...#.#.#                                                     #.#.#.#.....#.#...#...#.....#...#.#  
  ###.#.###############.#.#.#.#.###.#                                                     #.#.#.###.###.#####.###.#####.#####  
ZA..#.#...#.#.#...#...#.......#...#.#                                                   KN..#.#.......#.#.......#...#.#.#....FB
  #.#.#.###.#.#.#.###.#.###.###.###.#                                                     #.#.#####.#.#########.###.#.#.#.#.#  
  #...#.........#.......#.#.#........SM                                                   #.#.......#.#.....#.......#.#...#.#  
  ###########.###.#######.###########                                                     #############.#.###########.#######  
  #.#.....#...#...#...#...#.......#.#                                                     #.........#.#.#.#.#................KL
  #.#.#.###########.#.#.#.#.#.#####.#                                                     #.#####.#.#.###.#.###.#.#####.###.#  
WW....#.............#...#...#........LU                                                 WW..#...#.#.............#.....#.#...#  
  ###########.#.#####.###.#.#########                                                     #.###.###.###.###.#.#.#.#.###.###.#  
CQ..........#.#.....#...#.#...#.....#                                                   BX..#.......#...#.#.#.#.#.#.#.#.#.#..OH
  #.#######.###################.#.###                                                     #####.#.#####.#.###########.###.###  
  #.#.......#.....#.#...#.......#.#..PE                                                 KL....#.#.#.#.....#...#...#...#.....#  
  ###.#.#.###.#####.#.#####.#####.#.#                                                     #.#######.#########.#.###.#####.#.#  
  #.#.#.#.#.....#.......#...#.....#.#                                                     #.#...#...#...#.#.#.....#.#.#...#..GM
  #.###.###.#.#####.#.#####.#.#.###.#                                                     #.#.#.###.###.#.#.###.###.#.###.#.#  
  #.#.......#.......#.......#.#.....#                                                     #...#...........................#.#  
  #.#########.#.###.###.###.#####.###                                                     #####.#####.#.#####################  
  #.........#.#.#...#.#.#.#.#...#...#                                                   RO....#.#.#...#.#...#.#.#.#.........#  
  ###.#.#####.#####.#.#.#.#####.#####                                                     ###.###.#######.#.#.#.#.#.#.###.###  
WJ..#.#.#...#.#...#.#...#.....#.#.#..WA                                                   #.........#.....#.......#.#.#.....#  
  #.#.#.###.###.#.#######.#.#.#.#.#.#                                                     #.#######.#.###.###.###.#.#####.#.#  
  #.#.#...#.....#.#...#.#.#.#.....#.#                                                     #.#.......#.#.....#.#.#...#.....#.#  
  #.#.###.#.#.#.#####.#.###.#.#.#.#.#                                                     #.#####.###.#########.#.#.#######.#  
  #...#.....#.#.............#.#.#...#                                                     #.#.#.............#.....#.#...#....OB
  #.#.###.#.#.#####.###.#.#########.#    D       C       U           W       F   T        ###.#.###.###.#########.#.###.###.#  
  #.#.#...#.#...#.....#.#...#.#.....#    I       O       I           J       B   V        #.#.....#...#.#...#.#...#.#.......#  
  #.#####.###.#.###.###.#####.#.#.#######.#######.#######.###########.#######.###.#########.#.#######.#.#.#.#.###.###.###.#.#  
  #.....#.#.#.#...#.#.#...#.....#.#.......#...#.#.#...........#.#.#...#.........#.#.......#.#.#...#...#...#.#.....#.#.#.#.#.#  
  #.#####.#.#.#####.#.###########.#####.#.#.#.#.#.#####.###.###.#.#.#.###.#######.#.#.#.###.###.#######.#.###.#.#.#.#.#.###.#  
  #.#.#.#.#.#.#.....#.#.#...#.#.#.#.#...#...#.#.......#.#...#.#.....#.#.....#...#...#.#.#.........#.#...#.#...#.#.#.....#...#  
  ###.#.#.#.#######.#.#.#.###.#.#.#.#.#.###.#####.###.###.###.###.#####.###.###.#.###.#.#.#####.###.###.#.#.#.#.###########.#  
  #.............#...........#.....#...#.#...#.#.#...#...#.....#...#.#...#.....#...#.#.#...#...#.......#.#.#.#.#...#.........#  
  #####.#.#.#.#####.###############.#.#####.#.#.#.###.#######.###.#.#####.#######.#.#######.###.###.###.#.#####.###.###.###.#  
  #.....#.#.#...#.............#...#.#...#...#.......#.#.....#.#.#...#.#.....#.#.#.#...#.......#.#.#.#...#.#.#.#...#...#.#...#  
  ###.#.###.#####.#####.#########.#.#######.#.###.#.#####.#.#.#.###.#.###.#.#.#.#.#.###.###.#.###.###.#.###.#.#####.#.###.#.#  
  #...#.#.......#...#.....#.......#.#.#.#...#.#...#.#.....#...#.........#.#.#...#.........#.#...#.#...#.....#...#...#.#...#.#  
  ###.#####.#####.#######.#.###.#.###.#.#.###.#.#.#######.#######.#####.###.#.#.#.#####.#######.#.###.###.###.#######.#####.#  
  #.#.#.#.....#...#.......#.#...#.#.#.......#.#.#...#.#...#.#.#.#.#.....#.#...#.#.....#.#.#.........#.#.#.........#...#...#.#  
  #.###.###.###.#.#####.#.#####.###.#####.#######.###.###.#.#.#.#.###.#.#.#####.###.#####.###.#.###.###.#.#.###.#####.#.###.#  
  #...........#.#.#.....#.#.................#.#.#.....#.......#.#.#.#.#.#.......#.......#...#.#...#.#.#...#.#.....#.......#.#  
  #######.###.###.#.###.#####.#####.#.###.#.#.#.###.#####.###.#.#.#.#.#.###.#####.#####.#.###.###.###.#.#.#.###.###.#.#####.#  
  #...#.....#...#.#.#...#.....#.#...#.#...#.#.......#.......#.#.....#.#.#.....#.......#...#.#.#.....#...#.#...#.#...#.....#.#  
  ###.###.#####.#####.#.#####.#.#########.###.###.#.#####.#.###########.#.#.#####.#####.#.#.#.###########.#####.#.#.#.#.#.#.#  
  #.#.........#...#...#.....#.#...#.#.#.#...#...#.#...#.#.#.......#.....#.#...#.......#.#.#.#.#.....#.#.....#...#.#.#.#.#.#.#  
  #.#####.#####.#######.#########.#.#.#.#.#######.###.#.#.#############.#.#.#####.###.###.#.###.#####.###.###.###.#.#.#.#.###  
  #...........#.....#.#.#.................#.#.......#...#...#...#.....#.#.#.#.#.#.#.#.#.#.#...#...#.#.......#...#.#.#.#.#...#  
  #.###.#.###########.#.###.#.###.#.#.#.#.#.#.#####.#####.#.###.###.#.#.#.###.#.#.#.###.###.#####.#.###.#.#.#######.#.#######  
  #...#.#.......#.#...#.#.#.#.#.#.#.#.#.#.#.....#.....#...#...#.#.#.#.#.#.....#.......#.....#...#.#...#.#.#.....#...#.#.....#  
  #.#.###.#######.###.###.###.#.#########.###########.###.#####.#.#.#.#.#.#######.###.#.#####.###.#.#.#####.###.###.#####.###  
  #.#.#.#.......#.#.......#...#.......#.....#.#.#...#.#.#.#.....#...#...#.....#.#...#.#.............#.#.#.#.#.#...#.......#.#  
  #.###.#.###.###.#.###.#.#########.#.###.###.#.#.#.#.#.#.#.###.#.#######.#####.#.#####.#####.###.#####.#.###.#.#####.#.#.#.#  
  #...#.....#.#.#.#.#...#...#.#.#...#...#.#.......#.#.#.....#...#.....#.#...#...#.#.#...#...#.#.#.......#.#...#...#...#.#...#  
  #####.###.###.#.#######.#.#.#.#####.###.#######.#.#.#######.#####.#.#.#.#####.#.###.#.#.#####.#.#######.###.#######.###.###  
  #.#...#...#...........#.#...#...........#...#...#.....#.....#.#.#.#...#.....#...#...#...#.#.#.#.#.............#...#.#.#...#  
  #.#.#######.#.#.###.#.###.#.###########.#.#####.###########.#.#.#####.#.###.###.#.###.#.#.#.#.#####.###.#.#.###.###.#.#.###  
  #.......#...#.#.#.#.#.....#.#...#.........#.....#.......#...#.....#...#.#.#.#...#...#.#.#.#.#.......#.#.#.#.......#.#.....#  
  #.#######.#.#.#.#.###.#####.#.###########.#####.#.###.#####.#.#######.#.#.#####.###.#.###.#.#.###.###.#.#.###.#.#####.###.#  
  #...#.....#.#.#.#.....#...........#.#.#...#...#...#.#.....#.....#.....#...#.#.......#...........#.....#.#.#.#.#...#.....#.#  
  #.###.#.#########.#.#.#.#.#.###.#.#.#.#.###.#.#####.#.###.###.#####.#####.#.#.#.#.###.###.###.###.#########.#.###.#.#.#.#.#  
  #...#.#...#.......#.#.#.#.#.#...#...........#.#.........#.#.....#.....#.....#.#.#.#...#.....#...#...........#...#.#.#.#.#.#  
  #############################################.#.#####.#######.###.#####.###########.#######################################  
                                               B A     H       P   K     D           U                                         
                                               X A     Y       E   N     R           I                                         