#################################################################################
#.......#.A...........#.........#.......#.#.........#.............#...#..r......#
#.###.###.#####.#####.#.#######.#.#######.#.#.#####.#.#.#.#######.###.#.###.###.#
#...#.#...#.....#.#...#...#.....#.......#...#.#...#o#.#.#.#...#.#...#.#...#.#...#
#####.#.###.#####.#.###.#W###.#########.#####.#.#.###.#.#.#.#.#.###.#K###.#.#####
#.....#.#.#...#...#...#.#...#...........#...#...#.....#.#.#.#.#.#...#...#.#.....#
#M###.#.#.###.#.#####.#####.###########.#.#.###.#######.###.#.#.#.#####.#.#####.#
#.#...#...#...#.#...#.....#...#..z....#.#.#...#...#.....#...#.#.#.#...#.......#.#
#.###.###.#.###.#.#.#####.###.#.###.#.#.#.###.#####.#.###.###.#.#.#.#.#####.###.#
#...#...#.#.#....y#.....#.....#.#.#.#.#.#...#.#...#.#.#...#...#.#...#.#...#.#m..#
#.#.#####.#.###########.#######.#.#.#.#.###.#.#.#X#.#.#.###.###.#####.#.#.###.###
#.#.#...#.#s..#.......#.......#...#.#.#.#...#...#.#.#.#.#.#.#.......#...#...#...#
###.#.#.#.###.#.#####.###.###.#####.#.#.#.#######.#.###.#.#.#.#####.#######.###.#
#...#.#...#.#...#...#.#...#.......#.#.#.#.#.......#.....#.#.#.#.....#.....#.....#
#.###.#####.#####.#.#C#.###.#####.#.#.#.#.#####.###.#####.#.###.#####.#.#.#####.#
#.....#.....#.....#.#.#.#...#...#...#.#.#.#.F.#...#...#...#...#.#...#.#.#.....#.#
#.#######.#.###.###.#.#.#####.#.#######.#.#.#.###.###.###.###.#.#.#.#.#.#######.#
#.#.......#...#.#...#.#...#...#.#.......#...#.#.#...#.......#.#.#.#.#.#.........#
#.#.#########.#.#####.###N#.###.#.###########.#.###.#########.#.#.#.#.###########
#...#...#.......#.....#...#.#.#.#.......#...#.#...............#...#.#.#....q....#
#####.###.#######.#####.###.#.#.#######.#.#.#.#############.#####.#.#.#.#.#####.#
#g..#.....#.....#...#.#...#...#.......#.#.#.#..l..........#.#...#.#.#.#.#...#...#
###.#.#####.###.###.#T#.#.###.###.#####.###.#############.#####B#.#.#.#.###.#####
#...#.#...#...#.....#.#.#...#.#.#.#...#.#.......#.......#...#...#.#...#...#.....#
#.###.###.###.#####.#.###.###.#.#.#.#.#.#.#####.#.###.#####.#.###.#####.#######.#
#...#...#...#.#.#...#...#.I...#.#...#...#.....#.#...#.#...#...#.#...#.#.#.......#
###.###.#.###.#.#.#####.#####.#.#############.#####.#.#.#.#####.###.#.#.#.#######
#.....#.#...#.#.......#.#...#...........#.....#.....#...#.......#.#.#.#.#.......#
#.#####.###.#.#######.#.#.#.#####.#######.###.#.###########.###.#.#.#.#.#######.#
#...........#.#e....#.#...#...#...#.....#.#...#...#.........#.....#.#...#.......#
#.###########.#.###.#########.#####.###.#.#######.#.#####.#######.#.#####.#####.#
#.....#.#.....#.#.#.........#.......#...#.#.......#.#.....#.....#.#...#...#.#...#
#####.#.#.#####.#.#####.#.###########.###.#.#######.#####.#.###.#.###.#.###.#.###
#...#.#.#.......#.#.....#.#.........#.#.#...#.#.....#...#.#.#...#...#.#...#...#.#
#.###.#.#########.#.#####.#V#.#####.#.#.#.###.#.###.#.#.###.#.#######.###.#.###.#
#.#...#.....#.....#.#.....#.#...#...#.#.#.#...#.#.#.#.#.....#.........#...#.#...#
#.#.###.###.#.#####.#######.###.#.###.#.#.###.#.#.#.#.#################.###.#.#.#
#.#.....#.#.#.....#.......#.#.#.#...#.#.#.#...#.#...#.#.........#.......#.S.#.#.#
#.#######.#.#####.#######.#.#.#.#####.#.#.#.#.#.#####.#####.###.#.#######.###.#.#
#.......................#.....#.............#.#.............#.....#...........#.#
#######################################.@.#######################################
#...............#.....#.....#.............#.........................D.......#..u#
#.#############.#####.#.#.###.###.#####.#.#.#.#####.#######.###############.#.###
#.....#.....#...#...#...#.....#.#.#.....#...#....v#.#.....#.#.......#.....#.#.E.#
#####.#.#####.###.#.#.#########.#.#######.#######.###.###.###.#####.#.#####.#.#.#
#.....#.....#.....#.#.#...#.....#.......#.#.......#.....#.#...#...#.#....j#t#.#.#
#.#########.#######.#.#.#.#.###########.#.#.#######.#####.#.###.###.#####.#.#.#.#
#.......#...#...#...#...#...#.......#...#.#.#.....#.#.....#.#.....#.#...#.#.#.#.#
#######.#.#.###.#.#######.###.#####.#.#####.#.###.#.#.#####.#####.#.#.#.#.#.###.#
#.....#.#.#.....#...#.....#...#.....#...#...#.#.#...#.....#.......#...#.#.#.#...#
###.###.#.#####.###.#####.#.###.#####.#.#.#.#.#.#########.#######.#####.#.#.#.#.#
#...#...#...#...#.#.....#.#.#.#.#.....#.#.#d#.#.....#.......#.....#.....#.#...#.#
#.###.#####.#.###.#####.#.#.#.#.#######.#.###.###.#.#.#######.#####.#####.#####.#
#.....#...#.#.....#.....#.#.#.#...#.....#.....#...#.#.....#.....#...#...#.....#.#
#.#####.#.#.#.#####.#####.#.#.###.#.###.#######.#.#######.#.#####.#####.#.#.#.#.#
#.#.....#.#.#.#.....#.....#.#...#.#.#...#.......#.#.....#...#.#...#.....#.#.#.#.#
#.###.#.#.#.#.#.###########.###.#.#.#.###.#########.#.#######.#.#####.###.#.###.#
#.H.#.#.#.#.#.#.....#.....#.#...#...#...#.#.....#...#.........#.#.....#...#.....#
###.###.#.#.#.#####.#.###.#.#.#########.#.#.###.#.#######.#####.#.#.#.#.#########
#.#.#...#...#...#.#...#...#.#...#.......#...#.#...#.....#...#...#.#.#.#.........#
#.#.#.#.#######.#.#####.###.#.#.#.#######.###.#########.###.#.#####.#.#########.#
#...#.#.#...#.#.#...#...#...#.#.#...#...#...#...#.....#...#.#.#.....#.#.......#.#
#.###.###.#.#.#.###.#######.#.#.###.#.#.###.#.###.#.#.#.#.#.###.#####.###.###.#.#
#.#...#...#.#.#.#...........#.#...#.#.#.#.#.#.#...#.#...#.#.....#...#...#.#.#.#.#
#.###.#.###.#.#.#.###########.###.#.#.#.#.#.#.#.###.#####.#####.###.###.#.#.#.#.#
#...#...#.#.#.#...#...#.U...#.#.#...#.#.#...#.....#.#.....#...#...#...#...#...#.#
###.#.###.#.#.#####J#.#.#.###.#.#####.###.#######.#.#####.#.#####.#.#####.#####.#
#...#.Q.#.#.#.....#.#...#.....#.........#.......#.#f....#.L.#.....#h....#.#...#.#
#.#####.#.#.###.#.#.#################.#.#######.#.#####.###.#.#####.#.###.#.#.#.#
#.#...#...#...#.#.#.#...#.......#...#.#.#.#...G.#.....#.Z.#.#...#...#.....#.#...#
#.#.#####.###.###.#.#.#.#####.#.#.#.###.#.#.#############.#.###.#########.#.#####
#k#.#.....#.#...#.#..c#...#...#...#.#...#.#.#........n#...#...#.#.......#.#...#.#
#.#.#.#####.###.#.#######.#.#######.#.#.#.#.#.#######.#.###.###.#.#####.#####.#.#
#.#...#.....#...#.#.P...#.#.#.....#...#.#.#.#.#...#...#.#...#...#.....#.....#p..#
#.###.#.#.###.###.#.#.###.#.###.#.#####.#.#.#.#.###.###.###.#.#######.###.#####.#
#...#...#.#...#.#...#...#.#...#.#...#...#.O.#.#.....#.#...#b#.#.......#.#.#...#.#
###.#####.#.###.#.#####.#.###.#####.#.###.###.#.#####.#.#.###.#.#######.#.#.#.#.#
#.#.#.....#.#a..#.#...#.#.#...#.....#...#...#i#.#...#...#.Y.#.#.#....w..#.#.#...#
#.#R#######.#.#.#.###.#.#.#.###.#######.###.#.#.#.#.#######.#.#.#####.#.#.#.#####
#...........#.#.......#.....#...........#.....#x..#.........#.........#.#.......#
#################################################################################